##########
#00000000#
###000#00#
#00000000#
#000P0000#
#00000000#
#####0000#
#0000000##
#000000###
##########